130 130 130 130 130 130 130 130 130 130 130 130 130 130 130 130 130 130 130 130 130 130 130 130 130 130 130 130 130 130 130 130 130 130 130 130 130 140 140 140 140 140 140 130 130 130 130 130 130 130 130 130 130 130 130
130 130 130 130 130 130 130 130 130 130 130 130 130 130 130 130 130 130 130 130 110 122 122 122 122 122 122 122 122 122 122 122 122 113 130 130 130 130 121 102 103 120 130 130 130 130 130 130 130 130 130 130 130 130 130
140 130 130 130 130 130 130 130 130 130 130 130 130 130 130 130 130 130 130 130 121 133 133 100 100 100 100 100 100 100 100 133 133 120 130 130 130 130 121 102 103 120 130 130 130 130 130 130 130 130 130 130 130 130 130    
140 122 122 122 122 122 122 122 122 122 122 122 122 122 122 122 122 122 122 122 133 102 103 101 101 101 101 101 101 101 101 102 103 133 122 122 122 122 133 133 133 133 122 122 122 122 122 122 122 122 122 122 113 130 130
140 100 100 100 100 100 100 100 100 133 133 133 133 100 100 100 100 100 100 100 100 102 103 133 123 123 123 123 123 123 133 102 103 100 100 100 100 100 133 133 133 133 100 100 100 100 100 100 100 100 100 133 120 130 130
140 101 101 101 101 101 101 101 101 133 133 133 133 101 101 101 101 101 101 101 101 133 133 120 130 130 130 130 130 130 121 133 133 101 101 101 101 101 133 133 133 133 101 101 101 101 101 101 101 101 101 133 120 130 130
140 123 123 123 123 123 123 123 123 133 133 133 133 123 123 123 123 123 123 123 123 123 123 112 130 130 130 130 130 130 111 123 123 123 123 123 123 123 133 133 133 133 123 123 123 123 123 123 123 133 102 103 120 130 130
140 130 130 130 130 130 130 130 130 121 102 103 120 130 130 130 130 130 130 130 130 130 130 130 131 130 130 130 130 131 130 130 130 130 130 130 130 110 134 134 134 134 113 130 130 130 130 130 130 121 102 103 120 130 130
130 130 130 130 130 130 130 130 130 121 102 103 120 130 130 130 130 130 130 130 130 130 130 130 131 130 130 130 130 131 130 130 130 130 130 110 122 133 133 133 133 133 133 122 113 130 130 130 130 121 102 103 120 130 130
130 130 130 130 130 130 130 130 130 121 102 103 120 130 130 130 130 130 130 130 130 130 130 130 131 131 131 131 131 131 130 130 130 130 130 121 133 133 133 133 133 133 133 133 120 130 130 130 130 121 102 133 120 130 130
130 130 130 130 130 130 130 130 130 121 102 103 120 130 130 130 130 130 130 130 130 130 130 130 130 130 130 130 130 130 130 130 130 130 130 121 133 133 133 133 133 133 133 133 120 130 130 130 130 121 102 133 120 130 130
130 130 130 130 130 130 130 130 130 121 102 103 120 130 130 130 130 130 130 130 130 130 130 130 130 130 130 130 130 130 130 130 130 130 130 121 133 133 133 133 133 133 133 133 120 130 130 130 130 121 102 103 120 130 130
130 130 130 130 130 130 130 130 130 121 102 103 133 122 122 122 122 122 122 122 122 122 122 122 122 122 122 122 122 122 122 122 113 130 130 121 133 133 133 133 133 133 133 133 120 130 130 130 130 121 102 103 120 130 130
130 130 130 130 130 130 131 131 131 121 133 100 100 100 100 133 133 133 100 100 100 100 100 100 100 100 100 100 100 100 100 133 120 130 130 121 133 133 133 133 133 133 133 133 120 130 130 130 130 121 102 103 120 130 130
130 130 130 130 130 130 131 130 130 121 133 101 101 101 101 133 133 133 101 101 101 101 101 101 101 101 101 101 101 101 101 133 120 130 130 121 133 133 133 133 133 133 133 133 120 130 130 130 130 121 102 103 120 130 130
130 130 130 130 130 130 131 130 130 111 123 123 123 123 133 133 133 133 123 123 123 123 123 123 123 123 123 123 123 133 102 103 120 130 130 111 123 123 123 123 123 123 123 123 112 130 130 130 130 121 102 103 120 130 140
130 130 130 130 130 130 131 130 130 130 130 130 130 130 121 102 103 120 130 130 130 130 130 130 130 130 130 130 130 121 102 103 120 130 130 130 130 130 130 130 130 130 130 130 130 130 130 130 130 121 102 103 133 122 140
130 130 130 130 130 130 131 130 130 130 130 130 130 130 121 102 103 120 130 130 130 130 130 130 130 130 130 130 130 121 102 103 120 130 130 130 130 130 130 130 130 130 130 130 130 130 130 130 130 121 102 103 100 100 140
130 130 130 130 130 130 131 130 130 130 130 130 130 130 121 102 103 120 130 130 130 130 130 130 130 130 130 130 130 121 102 103 120 130 130 130 130 130 130 130 130 130 130 130 130 130 130 130 130 121 133 133 101 101 140
130 130 130 130 130 130 131 131 131 131 131 131 131 131 121 102 103 120 130 130 130 130 130 130 130 130 130 130 130 121 102 103 120 130 130 130 130 130 130 130 130 130 130 130 130 130 130 130 130 111 123 123 123 123 140
130 130 130 130 130 130 130 130 130 130 130 130 130 130 121 102 103 120 130 130 130 130 130 130 130 130 130 130 130 121 102 103 120 130 130 130 130 130 130 130 130 130 130 130 130 130 130 130 130 130 130 130 130 130 140
130 130 130 130 130 110 122 122 122 122 122 122 122 122 133 102 103 120 130 130 130 130 130 130 130 130 130 130 130 121 102 103 120 130 130 130 130 130 130 130 130 130 130 130 130 130 130 130 130 130 130 130 130 130 130
130 130 130 130 130 121 133 133 100 100 100 100 100 100 133 102 103 120 130 130 130 130 130 130 130 130 130 130 130 121 102 103 120 130 130 130 130 130 130 130 130 130 130 110 122 122 122 122 122 113 130 130 130 130 130
130 130 130 130 130 121 102 103 101 101 101 101 101 101 133 102 103 120 130 130 130 130 130 130 130 130 130 130 130 121 102 103 120 130 130 130 130 130 130 130 130 130 130 121 133 133 133 133 133 120 130 130 130 130 130
130 130 130 130 130 121 102 103 133 123 123 123 123 123 133 102 103 120 130 130 130 130 130 130 130 130 130 130 130 121 102 103 120 130 130 130 130 130 130 130 130 130 110 133 133 133 133 133 133 120 130 130 130 130 130
130 130 130 130 130 121 102 103 120 130 130 130 130 130 121 102 103 133 122 122 122 122 122 122 122 122 122 122 122 133 133 133 133 122 122 122 122 122 122 122 122 122 134 133 133 133 133 133 133 120 130 130 130 130 130
130 130 130 130 110 134 134 134 134 113 130 130 130 130 121 102 103 100 100 100 100 100 100 100 100 100 100 100 100 133 133 133 133 100 100 100 100 100 100 100 100 100 134 133 133 133 133 133 133 120 130 130 130 130 130
130 130 110 122 133 133 133 133 133 133 122 113 130 130 121 133 133 101 101 101 101 101 101 101 101 101 101 101 101 133 133 133 133 101 101 101 101 101 101 101 101 101 134 133 133 133 133 133 133 120 130 130 130 130 130
130 130 121 133 133 133 133 133 133 133 133 120 130 130 111 123 123 123 123 123 123 123 123 123 123 123 123 123 123 123 123 123 123 123 123 123 123 123 123 123 123 123 134 133 133 133 133 133 133 120 130 130 130 130 130
130 130 121 133 133 133 133 133 133 133 133 120 130 130 130 130 130 130 130 130 130 130 130 130 130 130 130 130 130 130 130 130 130 130 130 130 130 130 130 130 130 130 111 133 133 133 133 133 133 120 130 130 130 130 130
130 130 121 133 133 133 133 133 133 133 133 120 130 130 130 130 130 130 130 130 130 130 130 130 130 130 130 130 130 130 130 130 130 130 130 130 130 130 130 130 130 130 130 121 133 133 133 133 133 120 130 130 130 130 130
130 130 121 133 133 133 133 133 133 133 133 120 130 130 130 130 130 130 130 130 130 130 130 130 130 130 130 130 130 130 130 130 130 130 130 130 130 130 130 130 130 130 130 111 123 123 123 123 123 112 130 130 130 130 130
130 130 121 133 133 133 133 133 133 133 133 120 130 130 130 130 130 130 130 130 130 130 130 130 130 130 130 130 130 130 130 130 130 130 130 130 130 130 130 130 130 130 130 130 130 130 130 130 130 130 130 130 130 130 130
130 130 111 123 123 123 123 123 123 123 123 112 130 130 130 130 130 130 130 130 130 130 130 130 130 130 130 130 130 130 130 130 130 130 130 130 130 130 130 130 130 130 130 130 130 130 130 130 130 130 130 130 130 130 130
130 130 130 130 130 130 130 130 130 130 130 130 130 130 130 130 130 130 130 130 130 130 130 130 130 130 130 130 130 130 130 130 130 130 130 130 130 130 130 130 130 130 130 130 130 130 130 130 130 130 130 130 130 130 130